missy -> nebek, addax, cocco, grrrl, zhuzh, pfftt
mummy -> swans/snaws, effed, kibbi, cocco, grrrl, phpht
chalk -> dreer/reded/reerd/dreed/dered/deere/erred/reede/drere, gynny, bombo, jujus, xviii, pfftt
stick -> qajaq, mundu, hyphy, feeze, grrrl, oxbow
lipid -> buffs, qajaq, morro/mormo/moror, cwtch, keeve, gynny
click -> hexes, qajaq, urubu, gynny, modom/odoom, pfftt
scram -> ovolo, kibbi, gynny, jeeze, hudud, pfftt
gnash -> kudzu, civic, emmew, xylyl, robbo, pfftt
affix -> kudzu, cocco, grrrl, mebbe, phpht, wynns
stiff -> neemb, qajaq, kudzu, hyphy, cocco, grrrl
sword -> nebek, qajaq, civic, xylyl, zhuzh, pfftt
plunk -> qajaq, cwtch, gobbo, fyrds, mezze, xviii
bleed -> moron, qajaq, kuzus, cwtch, gyppy, xviii
clash -> kudzu, emmew, gynny, robbo, xviii, pfftt
comic -> addax, keeve, grrrl, zhuzh, wynns, pfftt
swarm -> nebek, civic, xylyl, doggo/goodo, zhuzh, pfftt
puffy -> nebek, qajaq, cwtch, grrls, xviii, modom/odoom
flask -> modoc, urubu, gynny, jeeze, xviii, phpht
comfy -> nebek, sudds, qajaq, grrrl, xviii, phpht
larva -> pudus/spuds, cwtch, gynny, jeeze, immix, boffo
undue -> qajaq, civic, grrrl, skyfs, bombo, phpht
expel -> buffs, qajaq, vizir, cwtch, gynny, modom/odoom
fizzy -> nebek, addax, cocco, grrrl, jujus, phpht
freed/defer -> swans/snaws, kibbi, cocco, jugum, xylyl, phpht
press/spree -> filii, qajaq, kudzu, cwtch, gynny, bombo
cheek/check -> wrong/grown, sudds, qajaq, xylyl, zimbi, pfftt
hutch -> femme, addax, kibbi, zoppo, grrrl, wynns
musky -> infix, qajaq, cwtch, zoppo, grrrl, ebbed
frisk -> ovolo, qajaq, cwtch, exeem/exeme, gyppy, bundu
crumb -> swans/snaws, hoogo/hogoh, xylyl, jeeze, vivid, pfftt
spell/sleep -> fromm/froom, qajaq, kudzu, cwtch, gynny, xviii
modem -> qajaq, civic, grrrl, zhuzh, wynns, pfftt
grown/wrong -> cheek/check/keech, sudds, qajaq, xylyl, zimbi, pfftt
bevel -> pudus/spuds, qajaq, cwtch, gynny, zokor, immix
catch/hatch -> kudzu, peepe, grrrl, immix, boffo, wynns
wheel -> kabar/bakra, sudds, cocco, gynny, immix, pfftt
swing -> bevel/belve, qajaq, kudzu, cocco, myrrh/rhymy, pfftt
flock -> dreer/reded/reerd/dreed/dered/deere/erred/reede/drere, qajaq, bubus/bussu, gynny, immix, phpht
munch -> patta/attap/tappa, jeeze, grrrl, skyfs, vivid, oxbow
scene -> moody/doomy, qajaq, kibbi, grrrl, zhuzh, pfftt
unzip -> qajaq, cwtch, grrrl, skyfs, vexed, bombo
skunk -> bevel/belve, qajaq, cwtch, gyppy, zorro, immix
blimp -> addax, cwtch, keeve, gynny, fuffs, zorro
brawn -> sughs, civic, xylyl, jeeze, modom/odoom, pfftt
flank -> dreer/reded/reerd/dreed/dered/deere/erred/reede/drere, cwtch, gyppy, bombo, jujus, xviii
rajah -> nebek, civic, xylyl, doggo/goodo, susus, pfftt
greed -> swans/snaws, civic, xylyl, bombo, zhuzh, pfftt
scant -> kudzu, hyphy, emmew, grrrl, xviii, boffo
cross -> nebek, qajaq, xylyl, vivid, zhuzh, pfftt
scold -> femme, qajaq, urubu, gynny, xviii, phpht
crank -> sughs, xylyl, jeeze, vivid, bombo, pfftt
class -> dreer/reded/reerd/dreed/dered/deere/erred/reede/drere, gynny, bombo, xviii, zhuzh, pfftt
scorn -> qajaq, begem, xylyl, vivid, zhuzh, pfftt
venue -> addax, cocco, grrrl, skyfs, zimbi, phpht
booze -> qajaq, civic, mundu, grrrl, skyfs, phpht
pound -> qajaq, cwtch, grrrl, skyfs, mebbe, xviii
slurp -> qajaq, effed, cwtch, gynny, bombo, xviii
abyss -> infix, kudzu, cocco, emmew, grrrl, phpht
spoof -> nebek, qajaq, cwtch, dummy/muddy, grrrl, xviii
verve -> swans/snaws, modoc, kibbi, xylyl, zhuzh, pfftt
kebab -> modoc, grrrl, xviii, zhuzh, wynns, pfftt
cinch -> emmys/messy, qajaq, kudzu, grrrl, oxbow, pfftt
kayak -> pudus/spuds, infix, cwtch, jeeze, grrrl, bombo
honor -> swizz, qajaq, edged/egged, xylyl, bucku, pfftt
excel -> buffs, qajaq, vizir, gynny, modom/odoom, phpht
comma -> kibbi, jeeze, grrrl, wynns, hudud, pfftt
ninny -> pudus/spuds, qajaq, cwtch, keeve, grrrl, bombo
verse/serve/sever -> infix, qajaq, kudzu, bobol, cwtch, gyppy
shorn -> qajaq, begem, kudzu, civic, xylyl, pfftt
swoop -> infix, qajaq, grrrl, mythy/thymy, bucku, deeve
vodka -> buchu, jeeze, grrrl, immix, wynns, pfftt
black -> dreer/reded/reerd/dreed/dered/deere/erred/reede/drere, gynny, sowms, xviii, zhuzh, pfftt
fluff -> nebek, rasas/arars/arras, cwtch, gyppy, xviii, modom/odoom
nasal -> femme, kudzu, cwtch, gyppy, robbo, xviii
crowd -> nebek, qajaq, miggs/gisms, xylyl, zhuzh, pfftt
papal -> dreer/reded/reerd/dreed/dered/deere/erred/reede/drere, kuzus, cwtch, gynny, immix, boffo
showy -> neemb, qajaq, kudzu, civic, grrrl, pfftt
crook/crock -> swans/snaws, begem, xylyl, vivid, zhuzh, pfftt
undid -> cezve, qajaq, grrrl, skyfs, bombo, phpht
wound -> cezve, qajaq, grrrl, skyfs, immix, phpht
civic -> wrong/grown, buffs, qajaq, deked, xylyl, phpht
sissy -> nebek, addax, cocco, grrrl, zhuzh, pfftt
needy -> buffs, qajaq, cwtch, zoppo, grrrl, immix
canny -> buffs, weeke, grrrl, xviii, modom/odoom, phpht
lurch -> swizz, addax, keeve, gynny, bombo, pfftt
humus -> wrong/grown, cezve, qajaq, kibbi, xylyl, pfftt
shook -> buzzy, addax, civic, emmew, grrrl, pfftt
grind -> cheek/check/keech, qajaq, xylyl, bombo, susus, pfftt
harsh -> nebek, cocco, jugum, xylyl, vivid, pfftt
verge -> swans/snaws, modoc, kibbi, xylyl, zhuzh, pfftt
geese -> brawn, civic, xylyl, zhuzh, modom/odoom, pfftt
krill -> pudus/spuds, qajaq, cwtch, exeem/exeme, gynny, boffo
dunce -> qajaq, grrrl, skyfs, bombo, xviii, phpht
never/nerve -> slobs/bolos/bools/lobos/obols/blobs/bolls, qajaq, kudzu, cwtch, gyppy, immix
slyly -> wrong/grown, femme, qajaq, kudzu, civic, phpht
ember -> swans/snaws, kudzu, ghyll, cocco, xviii, pfftt
skull/skulk -> moron, qajaq, effed, cwtch, gyppy, xviii
femme -> wrong/grown, sudds, qajaq, civic, xylyl, phpht
hunky -> swizz, addax, cocco, grrrl, mebbe, pfftt
flunk -> dreer/reded/reerd/dreed/dered/deere/erred/reede/drere, qajaq, boobs/bobos/obbos, cwtch, gyppy, immix
thumb -> addax, civic, peepe, nonno, grrrl, skyfs
staff -> neemb, kudzu, hyphy, cocco, grrrl, xviii
brisk -> femme, qajaq, undug, cwtch, zoppo, xylyl
brook -> swans/snaws, edged/egged, civic, xylyl, zhuzh, pfftt
chard -> lusus/sulus/sulls/lulls/lulus, weeke, gynny, bombo, xviii, pfftt
bushy -> kneed, qajaq, cocco, grrrl, immix, pfftt
smack -> buzzy, effed, nonno, grrrl, xviii, phpht
snoop/spoon -> biffy, qajaq, kudzu, cwtch, exeem/exeme, grrrl
lever/revel -> pudus/spuds, qajaq, cwtch, gynny, immix, boffo
skill -> dreer/reded/reerd/dreed/dered/deere/erred/reede/drere, qajaq, cocco, gynny, zhuzh, pfftt
swill -> cheek/check/keech, qajaq, urubu, gynny, modom/odoom, pfftt
shrub/brush -> cleck/cleek, qajaq, gynny, xviii, modom/odoom, pfftt
chasm -> buzzy, weeke, nonno, grrrl, vivid, pfftt
lynch -> dreer/reded/reerd/dreed/dered/deere/erred/reede/drere, qajaq, kuzus, gobbo, immix, pfftt
wryly -> nebek, sughs, qajaq, modoc, xviii, pfftt
smell -> infix, qajaq, kudzu, cwtch, gyppy, robbo
finch -> qajaq, kudzu, peepe, stymy, grrrl, oxbow
mushy -> nebek, qajaq, cocco, grrrl, vivid, pfftt
civil -> nebek, qajaq, doggo/goodo, myrrh/rhymy, susus, pfftt
moody -> swans/snaws, chuck, jeeze, grrrl, xviii, pfftt
cliff -> dreer/reded/reerd/dreed/dered/deere/erred/reede/drere, qajaq, kuzus, gynny, bombo, phpht
scoop -> qajaq, dukun, feeze, grrrl, xviii, mythy/thymy
bongo -> pudus/spuds, femme, qajaq, vizir, cwtch, xylyl
ovoid -> femme, qajaq, grrrl, bucku, phpht, wynns
chump -> tekke, qajaq, grrrl, vivid, boffo, wynns
knack -> pudus/spuds, jeeze, grrrl, xviii, mythy/thymy, boffo
swell -> fromm/froom, qajaq, kudzu, civic, gynny, phpht
husky -> neemb, qajaq, cocco, grrrl, vivid, pfftt
winch -> moody/doomy, qajaq, keeve, bubus/bussu, grrrl, pfftt
slunk -> dreer/reded/reerd/dreed/dered/deere/erred/reede/drere, qajaq, cwtch, gyppy, immix, boffo
weedy -> infix, qajaq, omovs, grrrl, bucku, phpht
shell -> qajaq, vizir, gynny, bucku, modom/odoom, pfftt
drawl -> cheek/check/keech, gynny, bombo, jujus, xviii, pfftt
naval -> dreer/reded/reerd/dreed/dered/deere/erred/reede/drere, kuzus, cwtch, gyppy, immix, boffo
dusky -> infix, cezve, qajaq, grrrl, bombo, phpht
tweet -> infix, sudds, qajaq, hyphy, cocco, grrrl
caddy -> nebek, grrrl, sowms, xviii, zhuzh, pfftt
scarf -> kudzu, bobol, emmew, gynny, xviii, phpht
buxom -> cheek/check/keech, qajaq, grrrl, vivid, wynns, pfftt
teeth -> compo, qajaq, kudzu, grrrl, xviii, wynns
kneel -> buffs, qajaq, vizir, cwtch, gyppy, modom/odoom
shiny -> qajaq, kudzu, cocco, exeem/exeme, grrrl, pfftt
skull/skulk -> moron, qajaq, effed, cwtch, gyppy, xviii
chuck -> wrong/grown, qajaq, semee/meses/smees/memes/mesem/seems/semes, xylyl, vivid, pfftt
shock -> buzzy, addax, emmew, jinni, grrrl, pfftt
newer/renew -> buffs, qajaq, civic, xylyl, doggo/goodo, phpht
sniff -> yuppy/puppy, addax, cwtch, keeve, grrrl, bombo
never/nerve -> slobs/bolos/bools/lobos/obols/blobs/bolls, qajaq, kudzu, cwtch, gyppy, immix
flung -> addax, civic, jeeze, skyrs, bombo, phpht
shirk -> cezve, qajaq, mundu, gobbo, xylyl, pfftt
wedge -> moron, buffs, qajaq, civic, xylyl, phpht
hedge -> moron, swizz, qajaq, xylyl, bucku, pfftt
karma -> pudus/spuds, ongon, cwtch, jeeze, xviii, flyby
steed -> qajaq, hyphy, nonno, grrrl, immix, bucku
uncut -> fifis, addax, hyphy, keeve, grrrl, bombo
flood -> nebek, qajaq, vizir, cwtch, gyppy, susus
prong -> buffs, qajaq, cwtch, xylyl, mezze, vivid
sandy -> civic, weeke, grrrl, bombo, zhuzh, pfftt
motto -> swans/snaws, effed, hyphy, grrrl, xviii, bucku
smoky -> addax, civic, grrrl, zhuzh, benne/ebene, pfftt
marsh -> belle/belee, kudzu, cocco, gynny, xviii, pfftt
minim -> patta/attap/tappa, cezve, grrrl, skyfs, oxbow, hudud
deuce -> qajaq, kibbi, grrrl, zhomo, wynns, pfftt
dizzy -> nebek, qajaq, wuffs, cocco, grrrl, phpht
swamp -> chynd, jeeze, grrrl, tuktu, xviii, boffo
cheer -> slobs/bolos/bools/lobos/obols/blobs/bolls, qajaq, kudzu, gynny, immix, pfftt
dwell -> buffs, qajaq, vizir, cocco, gynny, phpht
brood -> swans/snaws, civic, heeze, jugum, xylyl, pfftt
bunny -> shack/hacks, jeeze, grrrl, xviii, modom/odoom, pfftt
awake -> civic, grrrl, bombo, zhuzh, synds, pfftt
screw -> filii, qajaq, kudzu, gynny, bombo, phpht
spank -> cwtch, dummy/muddy, jeeze, grrrl, xviii, boffo
charm/march -> lusus/sulus/sulls/lulls/lulus, gynny, jeeze, vivid, oxbow, pfftt
flack -> dreer/reded/reerd/dreed/dered/deere/erred/reede/drere, gynny, bombo, jujus, xviii, phpht
gloss -> qajaq, dukun, myrrh/rhymy, xviii, zebec, pfftt
snaky -> civic, jeeze, grrrl, bombo, hudud, pfftt
scald -> brook, emmew, gynny, xviii, zhuzh, pfftt
block -> dreer/reded/reerd/dreed/dered/deere/erred/reede/drere, qajaq, wuffs, gynny, immix, phpht
eject -> swans/snaws, kudzu, hyphy, grrrl, immix, boffo
catch/hatch -> kudzu, peepe, grrrl, immix, boffo, wynns
stump -> qajaq, weeke, chynd, grrrl, xviii, boffo
spool/sloop -> femme, qajaq, kudzu, cwtch, gynny, xviii
mimic -> wrong/grown, buffs, qajaq, keeve, xylyl, phpht
crack -> bevel/belve, dowds/woods, gynny, immix, zhuzh, pfftt
slash/shall -> modoc, urubu, weeke, gynny, xviii, pfftt
groom -> swans/snaws, cezve, kibbi, xylyl, hudud, pfftt
humph -> nebek, qajaq, cocco, grrrl, vivid, xysts
quack -> effed, grrrl, bombo, xviii, phpht, wynns
drink -> lusus/sulus/sulls/lulls/lulus, qajaq, cwtch, exeem/exeme, gyppy, boffo
alarm -> pudus/spuds, cwtch, gynny, jeeze, xviii, boffo
canal -> sudds, gobbo, weeke, myrrh/rhymy, xviii, pfftt
creme -> swans/snaws, kibbi, xylyl, doggo/goodo, zhuzh, pfftt
floor -> nebek, sudds, qajaq, cwtch, gyppy, immix
thump -> addax, civic, nonno, jeeze, grrrl, skyfs
nymph -> stots/sotto/soots/toots/stoss/stott/ottos, qajaq, effed, grrrl, xviii, bucku
mucus -> wrong/grown, qajaq, effed, kibbi, xylyl, phpht
aback -> wrong/grown, femme, xylyl, vivid, jujus, phpht
welch -> kabar/bakra, gynny, jujus, xviii, modom/odoom, pfftt
brown -> cheek/check/keech, qajaq, muggs/smugs, xylyl, vivid, pfftt
icing -> bevel/belve, qajaq, skyrs, zhuzh, modom/odoom, pfftt
bench -> moody/doomy, qajaq, kuzus, grrrl, xviii, pfftt
stock -> femme, qajaq, hyphy, grrrl, xviii, bundu
enemy -> pudus/spuds, qajaq, cwtch, grrrl, xviii, boffo
refer/freer -> swans/snaws, kudzu, civic, gobbo, xylyl, phpht
bezel -> pudus/spuds, fromm/froom, qajaq, cwtch, gynny, xviii
rebel -> infix, qajaq, kudzu, omovs, cwtch, gyppy
slung -> addax, kibbi, cocco, jeeze, myrrh/rhymy, pfftt
crass -> femme, kudzu, bobol, gynny, xviii, phpht
conch -> emmys/messy, qajaq, kudzu, grrrl, xviii, pfftt
whiff -> compo, qajaq, kudzu, grrrl, benne/ebene, xysts
scrum -> nebek, qajaq, hoogo/hogoh, xylyl, vivid, pfftt
stunt -> femme, addax, hyphy, kibbi, cocco, grrrl
clack -> dreer/reded/reerd/dreed/dered/deere/erred/reede/drere, wuffs, gynny, bombo, xviii, phpht
sweep -> infix, qajaq, kudzu, cocco, grrrl, mythy/thymy
sense -> yuppy/puppy, qajaq, cwtch, kibbi, grrrl, modom/odoom
verse/serve/sever -> infix, qajaq, kudzu, bobol, cwtch, gyppy
whoop -> infix, qajaq, kudzu, cysts, grrrl, mebbe
bunch -> patta/attap/tappa, jeeze, grrrl, skyfs, xviii, modom/odoom
kappa -> bevel/belve, sudds, cwtch, gynny, zorro, immix
basal -> dreer/reded/reerd/dreed/dered/deere/erred/reede/drere, cocco, gynny, immix, zhuzh, pfftt
spill -> femme, qajaq, kudzu, cwtch, gynny, robbo
blond -> femme, qajaq, vizir, cwtch, gyppy, kukus/sukuk
grill -> femme, qajaq, kudzu, cocco, phpht, wynns
dandy -> cheek/check/keech, grrrl, bombo, jujus, xviii, pfftt
pygmy -> nebek, filii, addax, cwtch, zorro, jujus
fussy -> nebek, qajaq, modoc, grrrl, xviii, phpht
fifth -> qajaq, kudzu, peepe, cocco, grrrl, wynns
frond -> bevel/belve, qajaq, kuzus, cwtch, gyppy, immix
crawl -> buffs, gynny, jeeze, xviii, modom/odoom, phpht
evoke -> addax, mimic, grrrl, zhuzh, wynns, pfftt
plaza -> dreer/reded/reerd/dreed/dered/deere/erred/reede/drere, cwtch, jukus, gynny, immix, boffo
woody/dowdy -> nebek, qajaq, civic, smush/humus, grrrl, pfftt
mamma -> wrong/grown, cheek/check/keech, bubus/bussu, xylyl, vivid, pfftt
broom -> swans/snaws, edged/egged, civic, xylyl, zhuzh, pfftt
sneer -> filii, qajaq, kudzu, cwtch, gyppy, bombo
cling -> sudds, qajaq, keeve, myrrh/rhymy, oxbow, pfftt
frill -> nebek, qajaq, cwtch, gyppy, susus, modom/odoom
photo -> femme, qajaq, kudzu, civic, grrrl, wynns
drown -> cheek/check/keech, qajaq, xylyl, susus, zimbi, pfftt
sworn -> femme, qajaq, kudzu, civic, xylyl, phpht
queen -> addax, civic, grrrl, skyfs, bombo, phpht
twist -> femme, addax, hyphy, nonno, grrrl, bucku
mecca -> kudzu, grrrl, xviii, boffo, phpht, wynns
colon -> addax, kibbi, jeeze, myrrh/rhymy, susus, pfftt
gland -> civic, jeeze, kukus/sukuk, myrrh/rhymy, oxbow, pfftt
shaky -> civic, mundu, jeeze, grrrl, oxbow, pfftt
small -> dreer/reded/reerd/dreed/dered/deere/erred/reede/drere, civic, gynny, zhuzh, oxbow, pfftt
ranch -> boobs/bobos/obbos, weeke, jugum, xylyl, vivid, pfftt
brick -> dowls/wolds, qajaq, exeem/exeme, gynny, zhuzh, pfftt
verse/serve/sever -> infix, qajaq, kudzu, bobol, cwtch, gyppy
prism -> qajaq, dukun, cwtch, gobbo, xylyl, feeze
knoll -> dreer/reded/reerd/dreed/dered/deere/erred/reede/drere, buffs, qajaq, cwtch, gyppy, immix
scrub -> filii, qajaq, keeve, gynny, modom/odoom, phpht
sweet -> infix, qajaq, kudzu, hyphy, cocco, grrrl
sperm -> ongon, qajaq, kudzu, cwtch, xviii, flyby
shown -> buzzy, addax, keeve, mimic, grrrl, pfftt
child -> qajaq, brook, exeem/exeme, gynny, susus, pfftt
rigid -> swans/snaws, chuck, xylyl, jeeze, bombo, pfftt
emcee -> wrong/grown, buffs, qajaq, xylyl, vivid, phpht
funny -> swizz, addax, cocco, keeve, grrrl, phpht
spell/sleep -> fromm/froom, qajaq, kudzu, cwtch, gynny, xviii
crick -> swans/snaws, edged/egged, xylyl, bombo, zhuzh, pfftt
condo -> patta/attap/tappa, emmew, grrrl, skyfs, xviii, zhuzh
bless -> moron, qajaq, kudzu, cwtch, gyppy, xviii
shrub/brush -> cleck/cleek, qajaq, gynny, xviii, modom/odoom, pfftt
awash/swash -> nebek, vizir, cocco, jugum, xylyl, pfftt
wring -> cheek/check/keech, sudds, qajaq, xylyl, bombo, pfftt
hymen -> addax, kibbi, cocco, grrrl, jujus, pfftt
clown -> addax, kibbi, jeeze, myrrh/rhymy, susus, pfftt
synod -> femme, qajaq, grrrl, xviii, bucku, phpht
fetch -> qajaq, kudzu, grrrl, bombo, xviii, wynns
leper/repel -> buffs, qajaq, cwtch, gynny, xviii, modom/odoom
mucky -> swans/snaws, jeeze, bodoh, grrrl, xviii, pfftt
slump -> dreer/reded/reerd/dreed/dered/deere/erred/reede/drere, qajaq, cwtch, gynny, xviii, boffo
amaze -> kibbi, cocco, grrrl, wynns, hudud, pfftt
handy -> kuzus, cocco, emmew, grrrl, xviii, pfftt
press/spree -> filii, qajaq, kudzu, cwtch, gynny, bombo
bliss -> dreer/reded/reerd/dreed/dered/deere/erred/reede/drere, qajaq, cocco, gynny, zhuzh, pfftt
beset -> infix, qajaq, kudzu, hyphy, cocco, grrrl
droll/drool -> nebek, qajaq, cwtch, fuffs, gyppy, immix
shack -> buzzy, exeem/exeme, nonno, grrrl, vivid, pfftt
gloom -> cheek/check/keech, qajaq, urubu, vivid, wynns, pfftt
jiffy -> swans/snaws, kudzu, cocco, exeem/exeme, grrrl, phpht
chord -> bevel/belve, qajaq, kuzus, gynny, immix, pfftt
cluck -> swans/snaws, gobbo, jeeze, myrrh/rhymy, vivid, pfftt
pinky -> addax, cwtch, jeeze, fuffs, grrrl, bombo
chess -> minny, qajaq, kudzu, grrrl, oxbow, pfftt
grown/wrong -> cheek/check/keech, sudds, qajaq, xylyl, zimbi, pfftt
whisk -> bevel/belve, qajaq, cocco, gynny, durum, pfftt
wrung -> shack/hacks, xylyl, jeeze, vivid, bombo, pfftt
belch -> sudds, qajaq, morro/mormo/moror, gynny, xviii, pfftt
unwed -> qajaq, civic, grrrl, skyfs, bombo, phpht
shank -> buzzy, cocco, exeem/exeme, grrrl, vivid, pfftt
weave -> kudzu, syncs, grrrl, immix, boffo, phpht
drunk -> slobs/bolos/bools/lobos/obols/blobs/bolls, femme, qajaq, cwtch, gyppy, xviii
tenet -> compo, qajaq, grrrl, skyfs, vivid, zhuzh
macaw -> stots/sotto/soots/toots/stoss/stott/ottos, dukun, hyphy, jeeze, grrrl, xviii
spiny -> qajaq, kudzu, cwtch, exeem/exeme, grrrl, boffo
swoon -> cheek/check/keech, buzzy, qajaq, grrrl, immix, pfftt
tweed -> infix, qajaq, omovs, hyphy, grrrl, bucku
vivid -> wrong/grown, cheek/check/keech, qajaq, bubus/bussu, xylyl, pfftt
bloom -> pudus/spuds, qajaq, cwtch, keeve, gynny, frizz
chill/chili -> dreer/reded/reerd/dreed/dered/deere/erred/reede/drere, qajaq, kuzus, gynny, bombo, pfftt
theme -> qajaq, kudzu, civic, grrrl, boffo, wynns
hussy -> nebek, qajaq, modoc, grrrl, xviii, pfftt
downy -> cheek/check/keech, qajaq, bubus/bussu, grrrl, immix, pfftt
dense -> yuppy/puppy, qajaq, cwtch, grrrl, immix, boffo
drill -> cheek/check/keech, qajaq, gynny, bombo, susus, pfftt
madam -> wrong/grown, buffs, civic, xylyl, jeeze, phpht
salad -> fromm/froom, gynny, jeeze, xviii, bucku, phpht
speed -> infix, qajaq, cwtch, yukky, grrrl, bombo
fuzzy -> swans/snaws, civic, deked, grrrl, bombo, phpht
woozy -> nebek, addax, civic, smush/humus, grrrl, pfftt
banal -> dreer/reded/reerd/dreed/dered/deere/erred/reede/drere, cwtch, zoppo, jugum, skyfs, xviii
butch -> femme, qajaq, zoppo, grrrl, kynds, xviii
couch -> addax, kibbi, jeeze, grrrl, wynns, pfftt
spark -> cwtch, ungum, xylyl, jeeze, vivid, boffo
fever -> swans/snaws, kudzu, gobbo, mimic, xylyl, phpht
skiff -> yuppy/puppy, addax, cwtch, nonno, jeeze, grrrl
visit -> femme, addax, hyphy, nonno, grrrl, bucku
sunny -> cheek/check/keech, qajaq, grrrl, vivid, bombo, pfftt
dutch -> femme, qajaq, kibbi, zoppo, grrrl, wynns
chunk -> emmys/messy, qajaq, grrrl, vivid, oxbow, pfftt
muddy/dummy -> swans/snaws, civic, jeeze, grrrl, boffo, phpht
plumb -> dreer/reded/reerd/dreed/dered/deere/erred/reede/drere, ongon, qajaq, cwtch, skyfs, xviii
gypsy -> nebek, qajaq, vizir, cwtch, fluff, modom/odoom
snack -> vizir, gobbo, emmew, xylyl, hudud, pfftt
awash/swash -> nebek, vizir, cocco, jugum, xylyl, pfftt
pitch -> qajaq, kudzu, exeem/exeme, grrrl, boffo, wynns
sappy -> femme, kudzu, cwtch, nonno, grrrl, xviii
bluff -> moron, qajaq, cwtch, sexes, gyppy, vivid
shuck -> wrong/grown, qajaq, xylyl, mebbe, vivid, pfftt
slack -> dreer/reded/reerd/dreed/dered/deere/erred/reede/drere, gynny, bombo, xviii, zhuzh, pfftt
llama -> nebek, sudds, cwtch, gyppy, zorro, xviii
swirl -> femme, qajaq, kudzu, cocco, gynny, phpht
spurn -> femme, qajaq, cwtch, kibbi, xylyl, doggo/goodo
bound -> cezve, qajaq, grrrl, skyfs, immix, phpht
gamma/magma -> nebek, swizz, cocco, xylyl, uhuru, pfftt
proof -> nebek, qajaq, cwtch, muggs/smugs, xylyl, vivid
crook/crock -> swans/snaws, begem, xylyl, vivid, zhuzh, pfftt
cress/scree -> filii, qajaq, kudzu, gynny, bombo, phpht
cubic -> addax, keeve, grrrl, zhomo, wynns, pfftt
droop -> bevel/belve, qajaq, kuzus, cwtch, gynny, immix
sheer -> ovolo, qajaq, kudzu, mimic, gynny, pfftt
shyly -> wrong/grown, qajaq, kudzu, civic, exeem/exeme, pfftt
award -> nebek, fifis, cocco, jugum, xylyl, phpht
theft -> compo, qajaq, kudzu, grrrl, xviii, wynns
creek -> swans/snaws, gobbo, xylyl, vivid, zhuzh, pfftt
flick -> dreer/reded/reerd/dreed/dered/deere/erred/reede/drere, qajaq, gynny, bombo, susus, phpht
slosh -> dreer/reded/reerd/dreed/dered/deere/erred/reede/drere, qajaq, gynny, immix, bucku, pfftt
world -> cheek/check/keech, qajaq, bubus/bussu, gynny, immix, pfftt
funky -> swizz, addax, cocco, grrrl, mebbe, phpht
wacky -> infix, sudds, jeeze, grrrl, bombo, phpht
welsh -> qajaq, vizir, gynny, bucku, modom/odoom, pfftt
droll/drool -> nebek, qajaq, cwtch, fuffs, gyppy, immix
bosom -> welch, qajaq, kudzu, gynny, xviii, pfftt
drawn -> sughs, civic, xylyl, jeeze, bombo, pfftt
sheen -> moody/doomy, qajaq, grrrl, xviii, bucku, pfftt
lunch -> qajaq, edged/egged, skyrs, bombo, xviii, pfftt
bobby/booby -> swans/snaws, femme, kudzu, civic, grrrl, phpht
pence -> fifis, qajaq, kudzu, grrrl, mythy/thymy, oxbow
boozy -> swans/snaws, civic, exeem/exeme, grrrl, hudud, pfftt
elder -> infix, qajaq, kuzus, cwtch, gyppy, bombo
sleek -> infix, qajaq, cwtch, urubu, gyppy, modom/odoom
humid -> qajaq, cocco, keeve, grrrl, wynns, pfftt
crown -> buffs, qajaq, xylyl, mezze, vivid, phpht
stuck -> infix, qajaq, hyphy, grrrl, bombo, dewed
snoop/spoon -> biffy, qajaq, kudzu, cwtch, exeem/exeme, grrrl
bleep -> fromm/froom, sudds, qajaq, cwtch, gynny, xviii
mambo -> civic, weeke, grrrl, zhuzh, synds, pfftt
vigil -> nebek, addax, cocco, myrrh/rhymy, jujus, pfftt
refer/freer -> swans/snaws, kudzu, civic, gobbo, xylyl, phpht
wrack -> bevel/belve, gynny, dodos, immix, zhuzh, pfftt
cabby -> infix, keeve, grrrl, jujus, modom/odoom, phpht
bossy -> infix, qajaq, kudzu, cwtch, peepe, grrrl
moron -> pudus/spuds, qajaq, cwtch, kibbi, xylyl, feeze
seven -> yuppy/puppy, qajaq, cwtch, kibbi, grrrl, modom/odoom
candy -> wuffs, jeeze, grrrl, bombo, xviii, phpht
nanny -> pudus/spuds, cwtch, keeve, grrrl, immix, boffo
chick -> wrong/grown, sudds, qajaq, xylyl, mebbe, pfftt
event -> buffs, qajaq, hyphy, cocco, grrrl, immix
floss -> nebek, qajaq, cwtch, gyppy, xviii, durum
fleck -> swizz, qajaq, urubu, gynny, modom/odoom, phpht
penne -> biffy, qajaq, kudzu, omovs, cwtch, grrrl
brand -> fifis, cwtch, keeve, zoppo, jugum, xylyl
ledge -> fromm/froom, qajaq, xviii, bucku, phpht, wynns
champ -> kudzu, grrrl, jetee, xviii, boffo, wynns
chaff -> dukun, jeeze, grrrl, typps, bombo, xviii
fancy -> sudds, weeke, grrrl, bombo, xviii, phpht
clung -> dreer/reded/reerd/dreed/dered/deere/erred/reede/drere, qajaq, skyfs, bombo, xviii, phpht
grand -> femme, cwtch, kibbi, zoppo, xylyl, jujus
tooth -> femme, qajaq, kudzu, civic, grrrl, wynns
slush -> dreer/reded/reerd/dreed/dered/deere/erred/reede/drere, qajaq, civic, gynny, bombo, pfftt
witch -> qajaq, exeem/exeme, zoppo, grrrl, skyfs, bundu
shrew -> ovolo, qajaq, kudzu, mimic, gynny, pfftt
livid -> nebek, fromm/froom, qajaq, cwtch, gyppy, susus
chill/chili -> dreer/reded/reerd/dreed/dered/deere/erred/reede/drere, qajaq, kuzus, gynny, bombo, pfftt
level -> pudus/spuds, fromm/froom, qajaq, cwtch, kibbi, gynny
swift -> neemb, qajaq, kudzu, hyphy, cocco, grrrl
evade -> kibbi, cocco, grrrl, zhuzh, wynns, pfftt
frown -> addax, cezve, kibbi, jugum, slyly, phpht
forgo -> swans/snaws, kudzu, civic, xylyl, mebbe, phpht
beech -> wrong/grown, qajaq, kudzu, simis/mimis, xylyl, pfftt
frock -> bevel/belve, sudds, qajaq, gynny, immix, phpht
clang -> urubu, jeeze, skyfs, xviii, modom/odoom, phpht
blind -> fromm/froom, qajaq, cwtch, keeve, gyppy, susus
clink -> addax, gobbo, jeeze, myrrh/rhymy, susus, pfftt
howdy -> nebek, qajaq, civic, grrrl, susus, pfftt
fewer -> slobs/bolos/bools/lobos/obols/blobs/bolls, qajaq, kudzu, civic, gynny, phpht
maxim -> cocco, keeve, grrrl, zhuzh, synds, pfftt
dress -> ovolo, qajaq, kibbi, gynny, zhuzh, pfftt
spend -> qajaq, cwtch, yummy/mummy, grrrl, xviii, boffo
biddy -> swans/snaws, cocco, keeve, grrrl, zhuzh, pfftt
creed -> slobs/bolos/bools/lobos/obols/blobs/bolls, qajaq, gynny, immix, zhuzh, pfftt
snuff -> bevel/belve, qajaq, cwtch, gyppy, zokor, immix
spunk -> moody/doomy, qajaq, cwtch, feeze, grrrl, xviii
muddy/dummy -> swans/snaws, civic, jeeze, grrrl, boffo, phpht
dryly -> swans/snaws, begem, cocco, xviii, zhuzh, pfftt
delve -> moron, qajaq, cwtch, kibbi, fuffs, gyppy
bring -> cheek/check/keech, qajaq, xylyl, susus, modom/odoom, pfftt
dross -> nebek, qajaq, civic, xylyl, zhuzh, pfftt
mulch -> dreer/reded/reerd/dreed/dered/deere/erred/reede/drere, qajaq, boobs/bobos/obbos, gynny, xviii, pfftt
salsa -> infix, kudzu, verre/eever/reeve/verve, cwtch, gyppy, bombo
poppy -> nebek, sudds, qajaq, cwtch, grrrl, immix
adapt -> femme, kibbi, cocco, grrrl, zhuzh, wynns
prank -> femme, cwtch, gobbo, xylyl, vivid, jujus
clerk -> buffs, qajaq, gynny, xviii, modom/odoom, phpht
gamma/magma -> nebek, swizz, cocco, xylyl, uhuru, pfftt
match -> kudzu, peepe, grrrl, xviii, boffo, wynns
bawdy -> infix, jukus, cocco, grrrl, mezze, phpht
swish -> nebek, addax, cocco, yummy/mummy, grrrl, pfftt
slash/shall -> modoc, urubu, weeke, gynny, xviii, pfftt
smock -> bevel/belve, addax, gynny, zhuzh, wirri, pfftt
booth -> femme, qajaq, kudzu, civic, grrrl, wynns
drama -> nebek, ghyll, cocco, jujus, xviii, pfftt
savvy -> nebek, cocco, grrrl, immix, zhuzh, pfftt
lupus -> dreer/reded/reerd/dreed/dered/deere/erred/reede/drere, qajaq, cwtch, gynny, immix, boffo
newer/renew -> buffs, qajaq, civic, xylyl, doggo/goodo, phpht
dumpy -> infix, qajaq, boobs/bobos/obbos, cwtch, keeve, grrrl
gruff -> swans/snaws, cezve, kibbi, xylyl, modom/odoom, phpht
embed -> wrong/grown, qajaq, sicks/kicks, xylyl, zhuzh, pfftt
slink -> qajaq, cwtch, urubu, gyppy, feeze, modom/odoom
blush -> dreer/reded/reerd/dreed/dered/deere/erred/reede/drere, qajaq, cocco, gynny, immix, pfftt
usurp -> nakfa, cwtch, gobbo, xylyl, jeeze, vivid
parka -> filii, sudds, cwtch, gynny, jeeze, bombo
punch -> qajaq, kibbi, feeze, grrrl, modom/odoom, xysts
jumbo -> addax, civic, heeze, grrrl, wynns, pfftt
whirl -> addax, cezve, jukus, gynny, bombo, pfftt
glass -> dukun, civic, jeeze, myrrh/rhymy, oxbow, pfftt
blend -> fromm/froom, qajaq, kuzus, cwtch, gyppy, xviii
botch -> femme, qajaq, kudzu, grrrl, xviii, wynns
tepee -> hamba, kudzu, cocco, grrrl, xviii, wynns
leech -> swizz, qajaq, urubu, gynny, modom/odoom, pfftt
manga -> pudus/spuds, cwtch, xylyl, jeeze, boffo, kirri
belle -> swans/snaws, kudzu, cocco, myrrh/rhymy, xviii, pfftt
quick -> addax, heeze, grrrl, bombo, wynns, pfftt
spasm -> buzzy, effed, cwtch, nonno, grrrl, xviii
mossy -> nebek, addax, civic, grrrl, zhuzh, pfftt
stack -> mundu, hyphy, jeeze, grrrl, xviii, boffo
freed/defer -> swans/snaws, kibbi, cocco, jugum, xylyl, phpht
stunk -> femme, qajaq, civic, hyphy, grrrl, oxbow
shard -> ovolo, gynny, jeeze, immix, bucku, pfftt
myrrh -> swans/snaws, belle/belee, kudzu, cocco, xviii, pfftt
preen -> fifis, qajaq, kudzu, cwtch, gobbo, xylyl
growl -> femme, qajaq, kudzu, syncs, xviii, phpht
windy -> cheek/check/keech, qajaq, grrrl, bombo, susus, pfftt
clank -> sudds, gobbo, jeeze, myrrh/rhymy, xviii, pfftt
coach -> kudzu, grrrl, mebbe, xviii, wynns, pfftt
buddy -> swans/snaws, femme, cocco, grrrl, xviii, phpht
bobby/booby -> swans/snaws, femme, kudzu, civic, grrrl, phpht
shark -> civic, mundu, gobbo, xylyl, jeeze, pfftt
fjord -> palak/kalpa, cwtch, bubus/bussu, gynny, mezze, xviii
breed -> infix, ovolo, qajaq, kuzus, cwtch, gyppy
midst -> qajaq, hyphy, nonno, feeze, grrrl, bucku
kneed -> yuppy/puppy, fifis, qajaq, cwtch, grrrl, bombo
known -> pudus/spuds, qajaq, civic, feeze, grrrl, mythy/thymy
queue -> hamba, cocco, grrrl, kynds, xviii, pfftt
amass -> wrong/grown, cezve, kibbi, xylyl, hudud, pfftt
gross -> nebek, qajaq, civic, xylyl, zhuzh, pfftt
stint -> femme, qajaq, kudzu, hyphy, cocco, grrrl
brass -> cheek/check/keech, jugum, xylyl, nonno, vivid, pfftt
mound -> qajaq, cwtch, peepe, grrrl, skyfs, xviii
brink -> lusus/sulus/sulls/lulls/lulus, qajaq, cwtch, gyppy, feeze, modom/odoom
whack -> bevel/belve, sudds, gynny, zorro, immix, pfftt
timid -> nebek, qajaq, wuffs, hyphy, cocco, grrrl
blurb -> shack/hacks, gynny, jeeze, xviii, modom/odoom, pfftt
where -> slobs/bolos/bools/lobos/obols/blobs/bolls, qajaq, kudzu, civic, gynny, pfftt
lever/revel -> pudus/spuds, qajaq, cwtch, gynny, immix, boffo
melee -> pudus/spuds, qajaq, vizir, cwtch, gynny, boffo
seedy -> chunk, qajaq, grrrl, bombo, xviii, pfftt
blown -> addax, civic, heeze, jugum, skyrs, pfftt
radar -> welch, kuzus, gynny, bombo, xviii, pfftt
assay/sassy -> nebek, modoc, grrrl, xviii, zhuzh, pfftt
scent -> qajaq, kudzu, hyphy, grrrl, immix, boffo
fence -> stots/sotto/soots/toots/stoss/stott/ottos, qajaq, kudzu, hyphy, grrrl, immix
stuff -> nebek, qajaq, modoc, hyphy, grrrl, xviii
skimp -> buzzy, qajaq, effed, cwtch, nonno, grrrl
hobby -> swans/snaws, kudzu, civic, exeem/exeme, grrrl, pfftt
shady -> emmew, nonno, grrrl, xviii, bucku, pfftt
pinch -> qajaq, kudzu, emmew, grrrl, boffo, xysts
spool/sloop -> femme, qajaq, kudzu, cwtch, gynny, xviii
hitch -> qajaq, kudzu, peepe, grrrl, bombo, wynns
shrug -> nebek, qajaq, civic, xylyl, modom/odoom, pfftt
mammy -> nebek, swizz, cocco, grrrl, hudud, pfftt
sewer -> nakfa, cocco, jugum, xylyl, vivid, phpht
donor -> bevel/belve, qajaq, kuzus, cwtch, gyppy, immix
crash -> kudzu, bobol, emmew, gynny, xviii, pfftt
dwarf -> nebek, cocco, jugum, slyly, xviii, phpht
color -> buffs, qajaq, keeve, gynny, immix, phpht
gulch -> dreer/reded/reerd/dreed/dered/deere/erred/reede/drere, qajaq, bombo, xviii, wynns, pfftt
pagan -> buffs, morro/mormo/moror, cwtch, xylyl, jeeze, vivid
smash -> wrong/grown, xylyl, jeeze, vivid, bucku, pfftt
jewel -> shack/hacks, urubu, gynny, xviii, modom/odoom, pfftt
shush -> wrong/grown, cezve, qajaq, kibbi, xylyl, pfftt
puppy -> nebek, fifis, qajaq, cwtch, grrrl, modom/odoom
blank -> fromm/froom, sudds, cwtch, jeeze, gyppy, xviii
jumpy -> fifis, addax, cwtch, keeve, nonno, grrrl
cress/scree -> filii, qajaq, kudzu, gynny, bombo, phpht
slick -> dreer/reded/reerd/dreed/dered/deere/erred/reede/drere, qajaq, gynny, bombo, zhuzh, pfftt
blood -> hexes, qajaq, civic, gynny, muruk, pfftt
swung -> cheek/check/keech, qajaq, vizir, xylyl, bombo, pfftt
duchy -> swans/snaws, jeeze, grrrl, bombo, xviii, pfftt
kinky -> pudus/spuds, qajaq, cwtch, exeem/exeme, grrrl, boffo
penny -> buffs, qajaq, cwtch, grrrl, xviii, modom/odoom
cocoa/cacao -> femme, kudzu, grrrl, xviii, phpht, wynns
pooch -> femme, qajaq, kudzu, grrrl, xviii, wynns
smirk -> bevel/belve, addax, cocco, gynny, zhuzh, pfftt
grass -> nebek, civic, xylyl, zhuzh, modom/odoom, pfftt
bland -> fromm/froom, cwtch, jeeze, gyppy, kukus/sukuk, xviii
scowl -> dreer/reded/reerd/dreed/dered/deere/erred/reede/drere, qajaq, kibbi, gynny, zhuzh, pfftt
whiny -> addax, cezve, jukus, grrrl, bombo, pfftt
crush -> ovolo, addax, kibbi, emmew, gynny, pfftt
sprig -> femme, qajaq, kudzu, cwtch, xylyl, nonno
cabal -> dreer/reded/reerd/dreed/dered/deere/erred/reede/drere, jukus, gynny, xviii, zhomo, pfftt
brash -> ongon, kudzu, civic, emmew, xylyl, pfftt
blink -> fromm/froom, addax, cwtch, jeeze, gyppy, susus
which -> nebek, moody/doomy, qajaq, grrrl, susus, pfftt
tense -> qajaq, kudzu, civic, hyphy, grrrl, bombo
daddy -> nebek, wuffs, cocco, grrrl, immix, phpht
beefy -> swans/snaws, kudzu, cocco, grrrl, immix, phpht
idiom -> qajaq, heeze, grrrl, bucku, wynns, pfftt
clock -> hexes, qajaq, urubu, gynny, vivid, pfftt
chock -> swans/snaws, buzzy, exeem/exeme, grrrl, vivid, pfftt
jazzy -> nebek, sudds, cocco, grrrl, immix, phpht
heave -> kudzu, cocco, grrrl, immix, wynns, pfftt
widow -> qajaq, keeve, syncs, grrrl, zhuzh, pfftt
plump -> infix, qajaq, cwtch, gobbo, skyrs, deeve
genre/green -> buffs, qajaq, civic, xylyl, modom/odoom, phpht
snowy -> femme, qajaq, kudzu, civic, grrrl, phpht
wench -> moody/doomy, qajaq, kuzus, grrrl, xviii, pfftt
brawl -> cheek/check/keech, gynny, jujus, xviii, modom/odoom, pfftt
wreck -> slobs/bolos/bools/lobos/obols/blobs/bolls, qajaq, gynny, immix, zhuzh, pfftt
assay/sassy -> nebek, modoc, grrrl, xviii, zhuzh, pfftt
knock -> pudus/spuds, qajaq, feeze, grrrl, xviii, mythy/thymy
twixt -> nebek, sudds, qajaq, hyphy, cocco, grrrl
charm/march -> lusus/sulus/sulls/lulls/lulus, gynny, jeeze, vivid, oxbow, pfftt
frank -> lusus/sulus/sulls/lulls/lulus, cwtch, jeeze, gyppy, vivid, bombo
cocoa/cacao -> femme, kudzu, grrrl, xviii, phpht, wynns
hence -> moody/doomy, qajaq, kuzus, grrrl, xviii, pfftt
stood -> infix, qajaq, hyphy, emmew, grrrl, bucku
birch -> lusus/sulus/sulls/lulls/lulus, qajaq, keeve, gynny, modom/odoom, pfftt
cheek/check -> wrong/grown, sudds, qajaq, xylyl, zimbi, pfftt
cache -> kudzu, grrrl, bombo, xviii, wynns, pfftt
merge -> swans/snaws, kudzu, civic, xylyl, boffo, phpht
woody/dowdy -> nebek, qajaq, civic, smush/humus, grrrl, pfftt
pesky -> qajaq, mundu, cwtch, grrrl, xviii, boffo
hunch -> patta/attap/tappa, jeeze, grrrl, skyfs, vivid, bombo
cumin -> qajaq, grrrl, skyfs, phpht, deeve, oxbow
fanny -> pudus/spuds, cwtch, jeeze, grrrl, bombo, xviii
cynic -> hexes, qajaq, kudzu, grrrl, bombo, pfftt
drank -> filii, cwtch, jeeze, gyppy, bombo, susus
vouch -> addax, kibbi, jeeze, grrrl, wynns, pfftt
semen -> yuppy/puppy, qajaq, cwtch, grrrl, vivid, boffo
boost -> infix, qajaq, kudzu, hyphy, emmew, grrrl
paddy -> infix, cwtch, keeve, grrrl, bombo, jujus
climb -> dreer/reded/reerd/dreed/dered/deere/erred/reede/drere, qajaq, gynny, sooks/kooks, zhuzh, pfftt
genre/green -> buffs, qajaq, civic, xylyl, modom/odoom, phpht
scoff -> nebek, qajaq, wuddy, grrrl, immix, phpht
snuck -> moody/doomy, qajaq, heeze, grrrl, xviii, pfftt
churn -> swizz, qajaq, edged/egged, xylyl, bombo, pfftt
shawl -> modoc, urubu, gynny, jeeze, xviii, pfftt
leper/repel -> buffs, qajaq, cwtch, gynny, xviii, modom/odoom
spook -> infix, buzzy, qajaq, cwtch, grrrl, meved
